W W W W W W W W W W W W W
W D D P D D B D D D S D W
W D D D D D D D D D D D W
W D S D D D D D B D D D W
W D D D S D D D D D D S W
W D D D D D D D D D D B W
W B D B D D D D D D D D W
W D D D D D D D D D D S W
W S D D D D D D S D D D W
W D D D D D D D D D B D W
W D D D S D D B D D D D W
W W W W W W W W W W W W W