W W W W W W W W W W W W W
W - - P - - B - - - S - W
W - - - - - - - - - - - W
W - S - - - W - B - - - W
W - - - S - W - - - - S W
W - - - - - W - - - - B W
W B - B - - W - - - - - W
W - - - - - W - - - - S W
W S - - - - W - S - - - W
W - - - - - - - - - B - W
W - - - S - - B - - - - W
W W W W W W W W W W W W W