W W W W W W W W W W W W W
W D D D D D B D D D D K W
W D D K D D D D D D D D W
W D D D D D D D B D D D W
W D D D D D D D D K D D W
W D D D D D D D D D D D W
W D D B D D D D D D D D W
W D D D D D D D D D P D W
W D D D D K D D D D D D W
W D D E D D D D D D D D W
W D D D D K D B D D D D W
W W W W W W W W W W W W W