W W W W W W W W W W W W W
W D D P D D B D D D D D W
W D D D D D D D D D D D W
W D D D D D D D B D D D W
W D E D D D D D D D D K W
W D D D D D D D D D D B W
W B D B D D D D D D D D W
W D D D D D D D D D D K W
W K D D D D D D K D D D W
W D D D D D D D D D B D W
W D D D K D D B D D D D W
W W W W W W W W W W W W W