W W W W W W W W W W W W W
W D D K D D D D D D D E W
W B D D D B K D D D B D W
W D D D D D B D D D D D W
W D K D D C D D D D D D W
W D D D D D D D W D D D W
W D D D D D D D D D D D W
W D D D D D W W W D D D W
W D D D D K D D D D K D W
W W W W W W W W W W W W W